sfo - 49ers
chi - Bears
cin - Bengals
buf - Bills
den - Broncos
cle - Browns
tam - Buccaneers
ari - Cardinals
sdg - Chargers
kan - Chiefs
ind - Colts
dal - Cowboys
mia - Dolphins
phi - Eagles
atl - Falcons
nyg - Giants
jac - Jaguars
nyj - Jets
det - Lions
gnb - Packers
car - Panthers
nwe - Patriots
oak - Raiders
stl - Rams
bal - Ravens
was - Redskins
nor - Saints
sea - Seahawks
pit - Steelers
hou - Texans
ten - Titans
min - Vikings
afc - AFC
nfc - NFC
